F 76,76,76
C 99,99,99

NO sprites/test/north.xpm
SO sprites/test/south.xpm
WE sprites/test/west.xpm
EA sprites/test/east.xpm

11111111111
1S000000001
10000000001
10000000001
10000000001
10000D00001
10000000001
10000000001
10000000001
10000000001
11111111111
