F 76,76,76
C 99,99,99

NO sprites/test/north.xpm
SO sprites/test/south.xpm
WE sprites/test/west.xpm
EA sprites/test/east.xpm

1111111111111111111
10N0001001001000001
1001000001000001001
1000001001111101111
1001111000001001001
1000000000000001001
1001111111111001001
1111000000000001011
1000000001000000001
1111111111111111111
